     .----------.     
\   (  ||    ||  )  / 
 \   ~-||====||-~  /  
  \    ||    ||   /   
  |    ||====||  /    
  |__  ||    ||  |    
  | |\ ||====||__|    
  | | \      /|  |    
  | |  \    / |  |    
  | |   \__|  |  |    
  | |   |__|  |  |    
  | |   /  |  |  |    
  | |  /    \ |  |    
  | | /      \|  |    
  |_|/        |__|    
  |              |    
  |              |    
  /              \    
 /                \   
/                  \  
