.--.--.--.--.  .
|     |        |
:  :--:  :  :--:
|        |  |  |
:--:--:--:  :  :
|           |  |
:  :  :--:  :  :
|  |     |     |
:  :--:--:--:  :
|  |        |  |
:  :  :--:  :  :
|     |     |  |
:  :--:  :--:  :
|     |  |     |
:--:--:  :--:--: