,--------------------.-----------.-----------.
|                    |           |           |
|  .  .  ,--------   |   --.  .  `--------   |
|  |  |  |           |     |  |              |
|  |  :--"-----------:  ,--:  `--------------:
|  |  |              |  |  |                 |
|  |  |  ,--------.  "  |  `--.-----------.  |
|  |  |  |       X|     |     |           |  |
|  |  |  |  ,-----"-----'   --'   -----.  |  |
|  |  |  |  |                          |  |  |
:--'  |  |  |  ,--.-----.--------------'  |  |
|     |  |  |  |  |     |                 |  |
:--   |  |  |  |  "  .  |  ,--   ,--------'  |
|     |  |  |  |     |  |  |     |           |
|  .  |  |  |  `-----'  |  :--.  |  ,-----.  |
|  |  |  |  |           |  |  |  |  |     |  |
|  :--'  |  `--------.  |  |  |  |  |  .  "  |
|  |     |           |  |  |  |  |  |  |     |
|  |  ,--"--------.  |  |  |  |  |  `--"-----:
|  |  |           |  |  |  |  |  |           |
|  |  |  ,-----   "  |  |  |  |  :--------.  |
|  |  |  |           |  |  |  |  |        |  |
|  "  |  `-----------'  |  |  |  |  .  ,--'  |
|     |                 |  |  |  |  |  |     |
:--.  |  ,--.-----------'  |  "  `--'  |  .  |
|  |  |  |  |              |           |  |  |
|  "  |  "  |  ,--.  ,-----"-----------:  `--:
|     |     |  |  |  |                 |     |
|   --"-----'  |  "  |  ,-----   ,--   `--   |
|              |     |  |        |           |
`--------------"-----'  `--------"-----------'