.--.--.--.--.--.--.--.  .--.--.--.--.--.--.--.
|                    |        |     |     |  |
:  :--:  :--:--:--:--:  :--:  :  :  :  :  :  :
|     |     |              |     |     |  |  |
:--:  :--:  :  :--:--:--:  :--:--:--:  :  :  :
|     |     |     |     |           |  |  |  |
:--:--:  :--:  :--:  :  :--:--:  :  :  :  :  :
|        |     |     |           |  |  |     |
:  :--:--:  :--:  :  :--:  :--:--:  :  :--:--:
|           |     |     |  |     |  |  |     |
:--:--:--:--:  :--:--:  :--:  :--:  :  :  :  :
|           |  |     |     |     |  |     |  |
:  :  :  :--:  :  :  :--:  :--:  :  :--:--:  :
|  |  |     |  |  |     |        |     |  |  |
:  :  :--:  :  :  :--:  :--:--:--:--:  :  :  :
|  |     |           |  |           |  |     |
:--:--:  :--:--:--:  :--:  :--:--:  :  :--:--:
|     |  |     |           |     |  |  |     |
:  :  :--:  :  :  :--:--:--:  :  :  :  :  :  :
|  |  |     |  |           |  |  |  |     |  |
:  :  :  :--:--:  :--:--:  :  :  :--:--:--:  :
|  |  |  |     |     |     |  |        |     |
:  :  :  :  :  :--:  :  :--:--:  :--:  :  :--:
|  |     |  |  |     |        |     |  |     |
:  :--:--:  :  :--:--:--:--:  :  :  :--:--:  :
|        |  |     |     |     |  |  |     |  |
:  :--:  :  :--:  :  :  :  :--:--:  :  :  :  :
|  |     |  |     |  |     |     |  |  |  |  |
:  :  :--:  :  :--:  :--:--:  :  :  :  :--:  :
|  |     |  |  |              |     |     |  |
:  :  :--:  :--:  :--:--:--:--:  :--:  :  :  :
|  |     |        |           |     |  |     |
:  :--:  :--:--:--:  :--:--:  :--:  :--:--:--:
|  |     |           |        |  |           |
:  :  :--:--:--:--:  :  :--:--:  :  :--:--:  :
|  |     |     |     |  |     |     |     |  |
:  :--:  :  :  :  :--:  :  :--:  :--:  :  :--:
|  |     |  |  |     |     |     |     |     |
:  :--:--:  :  :  :  :--:--:  :--:  :--:--:  :
|  |        |  |  |  |     |  |        |     |
:  :  :  :--:  :  :  :  :  :  :--:--:  :  :--:
|     |     |  |  |  |  |  |           |  |  |
:  :--:--:  :  :  :  :  :--:  :--:--:--:  :  :
|     |     |     |  |  |     |        |  |  |
:--:--:  :--:--:  :--:  :  :  :  :--:  :  :  :
|        |     |  |     |  |  |     |  |  |  |
:  :--:--:  :--:  :  :--:  :  :  :  :--:  :  :
|        |     |  |        |  |  |     |  |  |
:--:--:  :  :  :  :--:--:--:--:  :  :  :  :  :
|     |  |  |  |     |     |     |  |  |     |
:  :  :  :--:  :  :--:  :  :  :  :--:  :  :--:
|  |           |        |     |  |           |
:--:--:--:--:--:--:--:--:--:--:--:  :--:--:--: